守門者貓頭鷹雕像	Gatekeeper Owl Sculpture	문지기 부엉이 조각상
迷路的靈魂	Lost Spirit	길 잃은 영혼
依依不捨的靈魂	Regret many souls	미련 많은 영혼
神聖的貓頭鷹雕像	Sacred Owl Sculpture	신성한 부엉이 조각상
憂鬱的貓頭鷹雕像	Gloomy Owl Sculpture	우울한 부엉이 조각상
那些怪物是從哪冒出來的？	Or Will the monster Where appeared?	저 몬스터들은 어디서 나타난 것일까요?
領路人靈魂	Guiding Spirit	길잡이 영혼
不知名的靈魂	Unknown Spirit	이름 모를 영혼
貓頭鷹雕像的等待	I wait for the owl image	부엉이 조각상의 기다림
安靜的森林(1)	The Silent Forest (1)	고요의 숲(1)
提議要消滅暗黑吉嘎利。	I'll get rid of the Black Zigri	검은 지그리를 처치하겠다고 제안한다
安靜的森林(2)	The Silent Forest (2)	고요의 숲(2)
安靜的森林(3)	The Silent Forest (3)	고요의 숲(3)
提議要確認關口。	We propose is to confirm the barrier	관문을 확인하겠다고 제안한다
安靜的森林(4)	The Silent Forest (4)	고요의 숲(4)
提議要尋找靈魂。	To provide that the try to find the soul	영혼을 찾아보겠다고 제안한다
在毒裡的靈魂(1)	Spiritual Poison (1)	독 안에 든 영혼(1)
提議要消滅赤紅普朗基。	I'll get rid of the Puragi	붉은 푸라기를 처치하겠다고 제안한다
在毒裡的靈魂(2)	Spiritual Poison (2)	독 안에 든 영혼(2)
提議要消滅暗黑南瓜精。	I'll get rid of the Black Sakamoli	검은 사카몰리를 처치하겠다고 제안한다
在毒裡的靈魂(3)	Spiritual Poison (3)	독 안에 든 영혼(3)
提議要確認貓頭鷹雕像。	To provide as try to check the owl image	부엉이 조각상을 확인해보겠다고 제안한다
在毒裡的靈魂(4)	Spiritual Poison (4)	독 안에 든 영혼(4)
貓頭鷹雕像的救援請求	Relief request of owl image	부엉이 조각상의 구원요청
提議要消滅死亡魔特斯。	I'll get rid of the Desmodus	데스모두스를 처치하겠다고 제안한다
森林裡滲入魔族(1)	Demon soaked in the Woods (1)	숲에 스며든 마족(1)
提出要主動幫忙。	We propose to give help	도움을 주겠다고 제안한다
森林裡滲入魔族(2)	Demon soaked in the Woods (2)	숲에 스며든 마족(2)
提議要尋找貓頭鷹雕像。	We propose that the visit the owl image	부엉이 조각상을 찾아가겠다고 제안한다
靈魂獵人(1)	Soul Hunter (1)	영혼 사냥꾼(1)
提出確認貓頭鷹雕像。	We propose is to confirm the owl image	부엉이 조각상을 확인하겠다고 제안한다
靈魂獵人(2)	Soul Hunter (2)	영혼 사냥꾼(2)
提出清除陷阱的建議。	We propose that you want to remove the trap	함정을 제거하겠다고 제안한다
靈魂獵人(3)	Soul Hunter (3)	영혼 사냥꾼(3)
提議要消滅幽靈范托群。	I'll get rid of the Hallowventers	할로우벤터 무리를 처치하겠다고 제안한다
靈魂獵人(4)	Soul Hunter (4)	영혼 사냥꾼(4)
提議要消滅幽靈范托的建議。	I'll get rid of the Hallowventer	할로우벤터를 처치하겠다고 제안한다
打開關口(1)	Opening the Barrier (1)	관문 열기(1)
打開關口(2)	Opening the Barrier (2)	관문 열기(2)
告訴貓頭鷹雕像靈魂的故事。	I willing to talk of soul in owl image	부엉이 조각상에게 영혼의 이야기를 전해준다
迷失的靈魂(1)	The Wandering Soul (1)	헤매는 영혼(1)
迷失的靈魂(2)	The Wandering Soul (2)	헤매는 영혼(2)
提出要消滅黑暗史萊姆的建議。	I'll get rid of the Dark Slime	다크 슬라임을 처치하겠다고 제안한다
迷失的靈魂(3)	The Wandering Soul (3)	헤매는 영혼(3)
比特雷巨蜂的襲擊	Attack of Biteregina	비테레지나의 습격
狼人的襲擊	Attack of Werewolf	웨어울프의 습격
占領魔法師之塔的魔君主	Ma was occupied the tower of wizard monarch	마법사의 탑을 점령한 마군주
報答財務的恩惠[轉職寬恕者](4)	Grace of Wealth [Pardoner Advancement] (4)	재물에도 은혜를[파드너 전직](4)
密室的秘室	Behind closed doors of secret	밀실의 비밀
我會接受打賭。	I'll take the bet	내기에 응하겠다고 한다
接受試驗。	I accept the test	시험을 받아 들인다
好奇心承認	Positive of curiosity	호기심의 긍정
我會幫忙。	I'll do it	해주겠다고 한다
與虛弱的貓頭鷹雕像對話	I interact with weak owl image	약한 부엉이 조각상과 대화한다
進入布袋頭嶺	Enter Top Grip Peak	자루머리 고개 진입
移動至布袋頭嶺	Move to the Top Grip Peak	자루머리 고개로 이동한다
消滅暗黑吉嘎利	Defeat Black Zigri	검은 지그리 처치
消滅暗黑吉嘎利	I'll defeat the Black Zigri	검은 지그리를 처치한다
回收骨灰盆	The recovered the remains	유골함을 회수
收集散佈在布袋頭嶺入口的骨灰盆。	Collect the urn boxes scattered throughout the entrance of Top Grip Peak	자루머리 고개입구에 흩어져 있는 유골함을 모아온다
確認靈魂的關口	Check the soul of the barrier	영혼의 관문 확인
確認後進入靈魂的關口	Come back to make sure the soul of the barrier	영혼의 관문을 확인하고 돌아온다
與迷路的靈魂對話	Lost souls and conversation	길 잃은 영혼과 대화
沿著往北的路往上走與迷路的靈魂對話	To talk to the lost souls to climb along the north of the road	북쪽길을 따라 올라가 길 잃은 영혼과 대화한다
與迷路的靈魂對話	I will talk to the lost souls	길 잃은 영혼과 대화한다
消滅赤紅普朗基	Red plastic machine treatment	붉은 푸라기 처치
消滅赤紅普朗基	I do red plastic machine treatment	붉은 푸라기를 처치한다
與依依不捨的靈魂對話	Regret many souls and conversation	미련 많은 영혼과 대화
與依依不捨的靈魂對話	I will talk to regret many souls	미련 많은 영혼과 대화한다
消滅暗黑南瓜精	Defeat Black Sakmoli	검은 사크몰리 처치
消滅暗黑南瓜精	I'll defeat the Black Sakmoli	검은 사크몰리를 처치한다
消滅暗黑南瓜精	Defeat Black Sakmoli	검은 사카몰리 처치
確認貓頭鷹雕像	Check the Owl Sculpture	부엉이 조각상 확인
確認貓頭鷹雕像	I'll check the Owl Sculpture	부엉이 조각상을 확인한다
消滅蜂湧而上的怪物	Defeat the surging monsters	몰려드는 몬스터 처치
消滅蜂湧而上的怪物	I'll defeat the surging monsters	몰려드는 몬스터를 처치한다
與神聖的貓頭鷹雕像對話	Talk with the Sacred Owl Sculpture	신성한 부엉이 조각상과 대화
與神聖的貓頭鷹雕像對話	I'll talk to the Sacred Owl Sculpture	신성한 부엉이 조각상과 대화한다
消滅死亡魔特斯 	Defeat Desmodus	데스모두스 처치
消滅死亡魔特斯 	I'll defeat the Desmodus	데스모두스를 처치한다
消滅赤紅漁人怪	Defeat Red Fisherman	붉은 피셔맨 처치
與憂鬱的貓頭鷹雕像對話	Conversation with gloomy owl image	우울한 부엉이 조각상과 대화
與憂鬱的貓頭鷹雕像對話	I interact with gloomy owl image	우울한 부엉이 조각상과 대화한다
確認空空的貓頭鷹雕像	Check the empty owl image	텅빈 부엉이 조각상 확인
確認空空的貓頭鷹雕像	I check the empty owl image	텅빈 부엉이 조각상을 확인한다
清除靈魂的陷阱	Pitfalls Delete soul	영혼의 함정 제거
找尋並清除靈魂的陷阱	You want to delete by searching the pitfalls of soul	영혼의 함정을 찾아서 제거한다
消滅地獄亡靈的部下	Load treatment of Necroventer	네크로벤터의 부하 처치
消滅地獄亡靈的部下	I will exterminate the load of Necroventer	네크로벤터의 부하들을 처치한다
消滅靈魂獵人的部下	Load treatment of soul of Hunter	영혼 사냥꾼의 부하 처치
消滅鑰匙管理幽靈范托	Treatment of key keeper Hello vendor	열쇠 지기 헬로우벤터 처치
消滅鑰匙管理幽靈范托並獲得鑰匙	I get the key to defeat key keeper Hello Venter	열쇠 지기 헬로우벤터 처치하고 열쇠를 획득한다
鑰匙管理	Key keeper	열쇠 지기
幽靈范托的部下	Load of hollow vendor	할로우벤터의 부하
與領路人靈魂對話	Soul and conversation of Assistant	길잡이 영혼과 대화
與領路人靈魂對話	I talk to the soul of the Assistant	길잡이 영혼과 대화한다
消滅擋路的怪物	I beat the monster to interfere	방해하는 몬스터를 처치
消滅擋路的怪物	I have defeated the monster that interfere	방해하는 몬스터를 처치한다
消滅地獄亡靈的殘黨	Remnants extermination of Necroventer	네크로벤터의 잔당 처치
消滅暗黑史萊姆	Black slime extermination	검은 슬라임 처치
消滅暗黑史萊姆	I will defeat the black slime	검은 슬라임을 처치한다
確認可疑的場所	Check the suspicious location	의심스런 장소 확인
確認可疑的場所	I confirm the suspected location	의심스런 장소를 확인한다
於限制時間內存活於撲上前來的怪物攻擊下。	I survive from between the time limit pounce monster attacks	제한 시간동안 덤벼드는 몬스터의 공격에서 살아 남는다
與不知名的靈魂對話	Soul a conversation with unknown name	이름 모를 영혼과 대화
與不知名的靈魂對話	I will talk to the soul of unknown name	이름 모를 영혼과 대화한다
消滅擋路的怪物	Monster extermination to block the road	길을 가로막는 몬스터 처치
請消滅比特雷巨蜂。	Please defeat Biteregina	비테레지나를 처치하세요
消滅比特雷巨蜂	Defeat Biteregina	비테레지나 처치
狼人出現了。	Werewolf appeared	웨어울프가 나타났습니다
消滅突然出現的狼人	Werewolf extermination that appeared suddenly	갑자기 나타난 웨어울프 처치
消滅狼人	Werewolf extermination	웨어울프 처치
消滅哈明	Hamin treatment	하밍 처치
尋找占領魔法師之塔的魔君主	Ma monarch search that occupied the tower of the wizard	마법사의 탑을 점령한 마군주 찾기
去見佩迪米安的道具商人	Meet with the Item Merchant of Fedimian	페디미안의 도구상인 만나기
和突然出現的劍士大師對話	Suddenly appeared Swordsman master and conversation	갑자기 나타난 소드맨 마스터와 대화
發現隱藏任務	Hidden Quest occurrence	히든 퀘스트 발생
消滅報喪女妖	Banshee treatment	밴시 처치
和突然出現的法師大師對話	Suddenly appeared wizard master and conversation	갑자기 나타난 위저드 마스터와 대화
拜訪法師大師	Find Wizard Master	위저드 마스터 찾아가기
和突然出現的弓箭手大師對話	Archer Master and conversation that appeared suddenly	갑자기 나타난 아처 마스터와 대화
和突然出現的牧師大師對話	Cleric master and conversation that appeared suddenly	갑자기 나타난 클레릭 마스터와 대화
在大教堂中尋找大理石雕像	Available from the Cathedral of marble sculpture	대성당에서 대리석 조각 구하기
將大理石雕像轉交給雕刻家泰斯拉	Marble sculpture transferred to the sculptor Tesla	조각가 테슬라에게 대리석 조각 전달
進入庫萊嶺	Enter Kule Peak	쿨레 고개 진입
移動至萊嶺	Move to Kule Peak	쿨레 고개로 이동한다
收集散佈在庫萊嶺入口的骨灰盆。	Collect the Remains' boxes that are scattered across Kule Peak	쿨레 고개입구에 흩어져 있는 유골함을 모아온다
正在配置引誘物	Placing handouts	유인물 배치 중
點火中	Lighting up	불 붙이는 중
Notice/已將靈魂的骨灰盆交給貓頭鷹雕像	Notice/Delivered the soul remains to the Weak Owl Sculpture	Notice/영혼의 유골함을 약한 부엉이 조각상에게 전달했습니다
安裝鑰匙中	Setting up the key	열쇠 설치 중
放餌中	Putting the bait	미끼를 놓는 중
除草劑始使用中	Using the herbicide	제초제 사용 중
Notice/請移動至下一地區。#5	Notice/Move to the next region#5	Notice/다음 지역으로 이동하세요#5
燃燒中	Burning	태우는 중
未爆彈處理(1)	Discarding Blind Shells (1)	불발탄 처리(1)
詢問如何處理。	What do I need to do?	어떻게 처리하는지 대해 묻는다.
未爆彈處理(2)	Discarding Blind Shells (2)	불발탄 처리(2)
直到最後一隻	Until the last one	마지막 한 마리까지
我會努力看看。	I will try my best	노력해 보겠다고 한다.
聽說那傢伙難搞所以我會拒絕。	He is too much for me	아무래도 그런 녀석은 벅차다며 거절한다.
未爆彈處理	Discarding Blind Shells (3)	불발탄 처리
解除未爆彈	Disable the Blind Shells	불발탄 해제하기
消滅樹林巨獸哥布林	Defeat Giant Wood Goblin	자이언트 우드 고블린 처치
奎波爾梅伊雷	Kupole Meile	큐폴 메일레
雪德利佳伊拉	Svitrigaila	쉬트리가일라
避開石化霜	Avoid the Petrifying Frost	석화 서리를 피해
怪物懷裡的部隊印章	The seal which the monster possesses	몬스터가 품은 부대 인장
觀察石化探測器	Look at the Petrification Detector	석화 탐지기 살펴 보기
避開石化霜	Avoid the Petrifying Frost	석화 서리 피하기
打開寶箱	Open the Treasure Chest	보물상자 열어보기
避開石化霜消滅怪物	Avoid the Petrifying Frost and defeat the monsters	석화서리를 피해 몬스터 처치하기
請和葳荷米娜凱利奧特對話	Talk to Wilhelmina Carriot	빌헬미나 캐리어트와 대화하세요
取得露克立斯的部隊印章、羊皮紙文件	Obtain Ruklys' Army Seals and Parchments	루클리스의 부대 인장, 양피지 문서 구하기
祭司尤塔	Priest Juta	사제 유타
信號	Signal	신호
斬斷尾巴(1)	Cutting the Tail (1)	꼬리자르기(1)
斬斷尾巴(2)	Cutting the Tail (2)	꼬리자르기(2)
斬斷尾巴(3)	Cutting the Tail (3)	꼬리자르기(3)
到達死胡同(1)	A Dead End (1)	막다른 곳에 다다라(1)
到達死胡同(2)	A Dead End (2)	막다른 곳에 다다라(2)
到達死胡同(3)	A Dead End (3)	막다른 곳에 다다라(3)
記錄文物避難所	Archive Shelter	기록물 대피소
高尚的魔君主	Elegant Demon Lord	고상한 마군주
尋找自我的旅程(1)	The Journey to Find Myself (1)	나를 찾는 여정(1)
尋找自我的旅程(2)	The Journey to Find Myself (2)	나를 찾는 여정(2)
尋找自我的旅程(3)	The Journey to Find Myself (3)	나를 찾는 여정(3)
尋找自我的旅程(4)	The Journey to Find Myself (4)	나를 찾는 여정(4)
尋找自我的旅程(5)	The Journey to Find Myself (5)	나를 찾는 여정(5)
尋找自我的旅程(6)	The Journey to Find Myself (6)	나를 찾는 여정(6)
無止盡的交易(1)	An Endless Deal (1)	끝없는 거래(1)
無止盡的交易(2)	An Endless Deal (2)	끝없는 거래(2)
無止盡的交易(3)	An Endless Deal (3)	끝없는 거래(3)
無止盡的交易(4)	An Endless Deal (4)	끝없는 거래(4)
勒肯家的悲劇(1)	The Legwyn Family's Tragedy (1)	르귄가의 비극(1)
勒肯家的悲劇(2)	The Legwyn Family's Tragedy (2)	르귄가의 비극(2)
勒肯家的悲劇(3)	The Legwyn Family's Tragedy (3)	르귄가의 비극(3)
執行	Progress	진행
修理中/HAMMERING/5/TRACK_AFTER/None	Repairing/HAMMERING/5/TRACK_AFTER/None	수리 중/HAMMERING/5/TRACK_AFTER/None
修理中/HAMMERING/3/TRACK_BEFORE/None	Repairing/HAMMERING/3/TRACK_BEFORE/None	수리 중/HAMMERING/3/TRACK_BEFORE/None
和團員伊魯曼塔斯對話	Talk with Member Irmantas	단원 이르만타스와 대화
拜訪團員克拉其那	Go meet Member Grazina	단원 그라지나와 찾기
好像聽到附近有人在叫我。	You can hear someone calling somebody	주변에서 누군가 부르는 소리가 들립니다.
和團員克拉其那對話	Talk with Member Grazina	단원 그라지나와 대화
將物品轉交給伊魯曼塔斯	Hand over the goods to Member Irmantas	이르만타스에게 물품 전달
拜訪團員阿爾利那	Go meet with Member Alina	단원 알리나 찾아가기
和團員阿爾利那對話	Talk with Member Alina	단원 알리나와 대화
和團員阿爾利那對話	Talk with Member Allin	단원 알린와 대화
燃燒中	Getting rid of it	소각 중
連保管所都找不到牠的蹤跡。	There aren't any traces of the storage left	보관소의 흔적조차 남아 있지 않습니다
為大體祈禱	Praying for the dead	시신의 명복을 비는 중
為死者祈禱	Praying for the dead	명복을 비는 중
挖掘中	Looking through it	헤쳐보는 중
挖掘中	Digging it	파 헤치는 중
請移動至下一個地區。	Move to another region	다음 지역으로 이동하세요
點火燃燒中	Lighting it up	불 불이는 중
守著雕像堆的火並消滅怪物！	Defeat all the monsters while protecting the fire around the pile of sculptures	조각상 더미의 불을 지키면서 몬스터를 모두 처치하세요!
收集商的圖鑑	The Collection of the collectors	수집상의 컬렉션
與收集商家對話	Talk with the collector	수집상과 대화
獲得收藏品	Obtained the collections	수집품 획득
魔族 雪德利佳伊拉	Demon Svitrigaila	마족 쉬트리가일라
寫在柱子上的字句	Writings on the Pillar	기둥에 적힌 글귀
[克勞斯的背景]	[Cleros' background]	[클레로스의 배경]
[克勞斯的最後一刻]	[The death of Cleros]	[클레로스의 최후]
[克勞斯之死，死亡以後]	[After the death of Cleros]	[클레로스의 죽음, 그 이후]
刻在柱子上的字句	Writings on the Pillar	기둥에 새겨진 글귀
[侏儒怪與月亮]	[Rumpelstiltskin and the Moon]	[럼펠스틸스킨과 달]
[侏儒怪與利迪亞夏班的弓箭]	[Rumpelstiltskin and Lydia Schaffen's Arrow]	[럼펠스틸스킨과 리디아 샤펜의 화살]
[侏儒怪在哪裡]	[Rumpelstiltskin's Whereabouts]	[럼펠스틸스킨은 어디에]
雷歐普達斯	Leopoldas	레오폴다스
安塔雷士	Antanas	안타나스
士兵靈魂	Soldier Spirit	병사 영혼
(好像昏迷了。)	(Seems to be unconscious)	(정신을 잃은 것 같다)
邪靈祭司 尤塔	Bokor Juta	보코르 유타
咒術人偶[邪靈祭司轉職]	Shaman Doll [Bokor Advancement]	주술인형[보코르 전직]
倒下傭兵的屍體	The dead body of the mercenary who has fallen	쓰러져 있는 용병의 시신
詢問該怎麼辦。	Ask him what you should do	어떻게 하면 되는 지 묻는다
要我看著辦所以拒絕。	Reject	알아서 하라며 거절한다
利迪亞夏班與造箭者的弓箭[造箭者轉職]	Lydia Schaffen and the Fletcher's Arrow [Fletcher Advancement]	리디아 샤펜과 플레쳐의 화살[플레쳐 전직]
我會找找看箭矢。	I will look for the arrow	화살을 찾아보겠다고 한다
因為沒信心而放棄。	Quit since you are not confident enough	자신없으니 그만둔다
詢問如果馴服怪物。	How can I tame the monster?	몬스터를 어떻게 길들이는 지 묻는다
胡說八道。	That's absurd	말도 안되는 소리라고 한다
一發必中[黑暗騎兵轉職]	Perfect Shot [Schwarzer Reiter Advancement]	일발필중[슈바르츠라이터 전직]
我有信心。	I am confident	자신있다고 한다
拒絕說並非如此。	That's not true	그렇지 않다고 거절한다
我會轉交。	I will pass it	전해주겠다고 한다
因為可疑而拒絕。	I don't want to do it	수상하니 거절해둔다
我會帶帳簿來。	I will go get the book	장부를 가져오겠다고 한다
我下次會再來。	I will come back later	다음에 다시오겠다고 한다
我會解決。	I will resolve it	해결하겠다고 한다
給我考慮的時間。	I need some time to think	생각할 시간을 달라고 한다
某人的記錄(1)	Someone's Record (1)	누군가의 기록(1)
正在刮灰塵	Scraping off dust	먼지를 긁어 내느 중
正在抖出黑粉	Brushing off the black powders	검은 가루를 털어 내는 중
某人的記錄(2)	Someone's Record (2)	누군가의 기록(2)
再次觀察中	Looking at it again	다시 살펴 보는 중
某人的記錄(3)	Someone's Record (3)	누군가의 기록(3)
正在觀察柱子	Looking at the pillar	기둥 살펴 보는 중
柱子的字句閱讀中	Reading the writings on the pillar	기둥의 글귀 읽는 중
刻在柱子上的人物(1)	Carvings on the Pillar (1)	기둥에 새겨진 인물(1)
正在閱讀柱子的字句	Reading the writings on the pillar	기둥의 글귀를 읽는 중
刻在柱子上的人物(2)	Carvings on the Pillar (2)	기둥에 새겨진 인물(2)
需要黏性液體。	You need viscous liquid	점성 있는 액체가 필요합니다
柱子修理中	Repairing the pillar	기둥 수리 중
刻在柱子上的人物(3)	Carvings on the Pillar (3)	기둥에 새겨진 인물(3)
正在塞碎片進去	Putting in the pieces	조각들을 끼워 넣는 중
收集聖物(4)	Collecting the Sacred Object (4)	성물 수집(4)
我會去挖掘。	I will go excavate it	발굴해 오겠다고 한다
聖物挖掘中	Excavating the Sacred Object	성물 발굴 중
我會收集看看。	I will collect them	모아보겠다고 한다
不會再進入了。	I won't go in again	다시 들어갈 일은 없다고 한다
記載著露克立斯部隊的相關事蹟。	The story written about the Ruklys Army	루클리스 부대와 관련된 이야기가 적혀있습니다
撤退指令	Order to Retreat	퇴각명령
旅程的開始(1)	The Journey Begins (1)	여정의 시작(1)
旅程的開始(2)	The Journey Begins (2)	여정의 시작(2)
旅程的開始(3)	The Journey Begins (3)	여정의 시작(3)
旅程的開始(4)	The Journey Begins (4)	여정의 시작(4)
歐勒夏(1)	Orsha (1)	오르샤(1)
歐勒夏(2)	Orsha (2)	오르샤(2)
歐勒夏(3)	Orsha (3)	오르샤(3)
帶著感恩之心	A Thankful Heart	감사의 마음을 담아
非常想要獻給你	Something to Give	꼭 드리고 싶어요
迷失於森林(1)	Lost in the Forest (1)	숲 속에서 길을 잃다(1)
迷失於森林(2)	Lost in the Forest (2)	숲 속에서 길을 잃다(2)
沒有主人的物品	An Unowned Object	주인없는 물건
不安全的安全地帶	Unsafe Safety Zone	안전하지 않은 안전지대
無法休息的移居民	The Settler Without Rest	쉴 수 없는 이주민
消失的主教(1)	The Missing Bishop (1)	사라진 주교(1)
消失的主教(2)	The Missing Bishop (2)	사라진 주교(2)
消失的主教(3)	The Missing Bishop (3)	사라진 주교(3)
消失的主教(5)	The Missing Bishop (4)	사라진 주교(5)
尋找被消除的痕跡	The Missing Bishop (5)	지워진 흔적 찾기
被燒毀的蹤跡(1)	The Burnt Whereabouts (1)	불타버린 행방(1)
被燒毀的蹤跡(2)	The Burnt Whereabouts (2)	불타버린 행방(2)
尋找被消除的痕跡(5)	Search for the Erased Traces (5)	지워진 흔적 찾기(5)
尋找被消除的痕跡(6)	Search for the Erased Traces (6)	지워진 흔적 찾기(6)
情報員的苦差	Overworked Agent	정보원의 격무
消除味道	Removing the Odor	냄새 없애기
轉變方向	Turning Away	발길 돌리기
怪物群落地(1)	Monster Colony (1)	몬스터 군락지(1)
怪物群落地(2)	Monster Colony (2)	몬스터 군락지(2)
大規模搜索(1)	Large-Scale Search Operation (1)	대규모 수색(1)
大規模搜索(2)	Large-Scale Search Operation (2)	대규모 수색(2)
大規模搜索(3)	Large-Scale Search Operation (3)	대규모 수색(3)
大規模搜索(4)	Large-Scale Search Operation (4)	대규모 수색(4)
大規模搜索(5)	Large-Scale Search Operation (5)	대규모 수색(5)
大規模搜索(6)	Large-Scale Search Operation (6)	대규모 수색(6)
輔助活動	Support Activities	보조 활동
可疑場所	The Suspicious Location	수상한 장소
事前調查(1)	Preliminary Investigation (1)	사전 조사(1)
事前調查(2)	Preliminary Investigation (2)	사전 조사(2)
汙染的怪物	The Corrupted Monster	오염된 몬스터
比錢還珍貴的性命	Precious Life and Money	돈 보다 귀한 목숨
回收本錢	Retrieve the capital	밑천 회수
危險線索(1)	The Dangerous Trace (1)	위험한 단서(1)
危險線索(2)	The Dangerous Trace (2)	위험한 단서(2)
危險線索(3)	The Dangerous Trace (3)	위험한 단서(3)
烏魯波納斯的下落(1)	Bishop Urbonas' Whereabouts (1)	우르보나스의 행방(1)
烏魯波納斯的下落(2)	Bishop Urbonas' Whereabouts (2)	우르보나스의 행방(2)
烏魯波納斯的下落(3)	Bishop Urbonas' Whereabouts (3)	우르보나스의 행방(3)
烏魯波納斯的下落(4)	Bishop Urbonas' Whereabouts (4)	우르보나스의 행방(4)
烏魯波納斯的下落(5)	Bishop Urbonas' Whereabouts (5)	우르보나스의 행방(5)
烏魯波納斯的下落(6)	Bishop Urbonas' Whereabouts (6)	우르보나스의 행방(6)
烏魯波納斯的下落(7)	Bishop Urbonas' Whereabouts (7)	우르보나스의 행방(7)
辦事確實	Do the task properly	일처리는 확실히
新敵人	A New Enemy	새로운 적
魔族包袱(1)	A Pile of Demons (1)	마족 꾸러미(1)
魔族包袱(2)	A Pile of Demons (2)	마족 꾸러미(2)
掌心之中(5)	Into the Hands (5)	손아귀 속으로(5)
掌心之中(6)	Into the Hands (6)	손아귀 속으로(6)
如果又如果(1)	What If Again (1)	만약에 또 만약에(1)
如果又如果(2)	What If Again (2)	만약에 또 만약에(2)
驅逐	To Expel	쫓아내기
募集囚犯	Recruiting Prisoners	죄수 모집
在更深處(1)	A Deeper Place (1)	더 깊은 곳에서(1)
在更深處(2)	A Deeper Place (2)	더 깊은 곳에서(2)
在更深處(3)	A Deeper Place (3)	더 깊은 곳에서(3)
在更深處(4)	A Deeper Place (4)	더 깊은 곳에서(4)
請再等一下。	Tell him to wait a bit	좀 더 기다려 달라고 한다
全部還原(1)	Everything Intact (1)	모든 것이 제자리로(1)
全部還原(2)	Everything Intact (2)	모든 것이 제자리로(2)
除銹	Eliminate the rust	녹 제거
珍貴的	Precious and Valuable	소중하고 귀중한
想法轉換	Change of One's Thinking	발상의 전환
全部還原(3)	Everything Intact (3)	모든 것이 제자리로(3)
餵食飛行型怪物	Feeding the aerial monsters	비행형 몬스터에게 먹이주기
跟馴鷹者大師報告	Report to Falconer Master	응사 마스터에게 보고
對普通怪物連續命中200次	Shoot normal monsters 200 times consecutively	일반 몬스터에게 연속 200회 명중
尋找躲藏的接頭人並轉交物品	Find the hidden contact and hand over the object	숨어있는 접선자를 찾아 물건 건내기
跟武僧大師報告	Report to Monk Master	몽크 마스터에게 보고
搜索寬恕者大師的帳簿	Search the book of Pardoner Master	파드너 마스터의 장부 수색
收集植物怪物的樣本	Collect the samples of Plant-type monsters	식문 몬스터의 샘플 수집
轉交給德魯伊大師	Hand them over to Druid Master	드루이드 마스터에게 전달
在峽谷地帶 36_1設置淨化的羅姆巴	Set Romuva of Purification at 36_1 of Canyon Region	협곡지대 36_1에 정화의 로무바 설치
跟神諭師大師報告	Report to Oracle Master	오라클 마스터에게 보고
開啟寶箱	Open the treasure chest	보물상자 열어 보기
避開石化霜消滅怪物	Defeat the monsters by avoiding the Petrifying Frost	석화서리를 피해 몬스터 처치
觀察柱子	Look at the pillar	기둥 살펴 보기
守護柱子	Protect the pillar	기둥 지키기
從柱子裡抖出粉末	Brush off the powders off from the pillar	기둥에서 가루 털어내기
取得怪物油脂	Collect Monster Oil	몬스터 기름 구하기
閱讀刻在柱子上的字句	Read the writings on the pillar	기둥에 새겨진 글귀 읽기
消滅怪物獲得怪物油脂	Defeat monsters to obtain Monster Oil	몬스터를 처치하여 몬스터 기름 획득
說出數字	Speak out the numbers	숫자 말하기
補修柱子	Repair the pillar	기둥 보수 하기
閱讀柱子的字句	Read the writings on the pillar	기둥의 글귀 읽기
取回黏性液體	Obtain Sticky Liquid	점성 있는 액체 구해 오기
修理柱子	Repair the pillar	기둥 수리하기
取得黏性液體	Obtain the sticky liquid	점성있는 액체 구하기
在柱子裡塞入碎片	Put the pieces into the pillars	기둥에 조각들 끼워 넣기
前來挖掘聖物	Excavate the sacred object	성물 발굴해 오기
跟尤拉泰報告	Report to Jurate	유라테에게 보고
收集露克立斯的部隊印章和羊皮紙文件	Obtain Ruklys' Army Seals and Parchments	루클리스의 부대 인장과 양피지 문서 수집
轉交給葳荷米娜凱利奧特	Hand them over to Wilhelmina Carriot	빌헬미나 캐리어트에게 전달
和露克立斯部隊士兵靈魂對話	Talk with the Ruklys Army Soldier's Spirit	루클리스 부대 병사 영혼과 대화
請和露克立斯部隊士兵靈魂對話。	Talk with the Ruklys Army Soldier's Spirit	루클리스 부대 병사 영혼과 대화하세요
吹響號角並告知靈魂們撤退命令	Pass the retreat order to the spirits by blowing the horn	나팔을 불어 영혼들에게 퇴각 명령 알리기
和祭司伊魯瑪對話	Talk with Priest Irma	사제 이르마와 대화
消滅魔君主馬魯若斯	Defeat Demon Lord Marnox	마군주 마르녹스 처치
什麼也得不到。	You obtained nothing	아무것도 얻지 못했습니다
委託石	Stone of Requests	의뢰석
魔法協會的收集委託	Magic Association Collection Request	마법협회의 수집 의뢰
保管室可疑的秘密裝置	Storage Room's Suspicious Secret Device	보관실의 수상한 비밀 장치
囚犯的信件(2)	Letters from Prison (2)	죄수의 편지(2)
外城壁核心回收作戰(1)	Operation Outter Wall Core Retrieval(1)	외성벽 코어 회수 작전(1)
正在和其他奎波爾們說調查的內容	Talking with other Kupoles	다른 큐폴들과 조사한 내용 이야기 중
外城壁的證據保存	Preserve the Evidence of the Outter Wall	외성벽의 증거 보존
確認委託石	Check the Stone of Requests	의뢰석 확인
獲得怪物標本	Obtain Monster Samples	몬스터 표본 획득
向委託石報告	Report to the Stone of Requests	의뢰석에 보고
和重裝步兵次級大師對話	Talk to the Hoplite Submaster	하플라이트 서브 마스터와 대화
與念力法師次級大師對話	Talk to the Psychokino Submaster	사이코키노 서브 마스터와 대화
轉交給念力法師次級大師	Deliver to the Psychokino Submaster	사이코키노 서브 마스터에게 전달
和鎖鏈法師次級大師對話。	Talk to the Linker Submaster	링커 서브 마스터와 대화
轉交材料給鎖鏈法師次級大師	Deliver the Materials to the Linker Submaster	링커 서브 마스터에게 재료 전달
為了國民和盾牌的劍[高地戰士轉職]	A Sword and Shield for the People [Highlander Advancement]	국민과 방패를 위한 검[하이랜더 전직]
飛禽的妨礙[輕裝步兵轉職]	Disturbance of the Winged Beast [Peltasta Advancement]	날짐승의 방해[펠타스타 전직]
第一支箭[弓箭手轉職]	The First Arrow [Archer Advancement]	첫 번째 화살[아처 전직]
治療師之路[牧師轉職]	Path of the Healer [Cleric Advancement]	치유사의 길[클레릭 전직]
永遠的敬拜[聖火祭司轉職]	Eternal Worship [Krivis Advancement]	영원한 경배[크리비 전직]
確認前往第1保管倉庫路上的秘密裝置	Check the Secret Device on the way to Supply Depot Number 1	제1 보관창고로 가는 길에 있는 비밀 장치 확인
破壞秘密裝置周邊出現的冰結水晶	Destroy the Ice Crystals that appeared next to the Secret Device	비밀 장치 주변에 나타난 빙결 수정 파괴
外城壁核心回收作戰	Operation Outter Wall Core Retrieval	외성벽 코어 회수 작전
和奎波爾密爾達對話	Talk to Kupole Milda	큐폴 밀다와 대화
奎波爾密爾達說核心有多重保護，而且怪物多又具攻擊性，這件事不太容易處理。為了安全的調查，請消滅周圍的怪物。	Kupole Milda says that the core is heavily protected by several means and monsters are large in number	큐폴 밀다는 코어가 다중으로 보호되고 있는 데다 어쩐지 몬스터들이 많고 공격적이어서 일이 쉽지 않다고 합니다. 안전한 조사를 위해 주변의 몬스터를 처치하세요.
消滅外城壁第9區域的怪物	Defeat Monsters in the Outter Wall District 9	외성벽 제 9구역의 몬스터 처치
跟奎波爾密爾達報告	Report to Kupole Milda	큐폴 밀다에게 보고
閔希豪森男爵	Baron Munchausen	뮌히하우젠 남작
紅色礦石龜的外殼碎片	Red Infrorocktor Shell Fragment	붉은 인프로 락터 껍질 조각
使用大教堂懺悔路挑撥用寶珠	Use the provoking orb at the Penitence Route in the Great Cathedral	대성당 참회로에서 도발용 보주 사용
在大教堂的懺悔路收集品質很好的磨刀石	Gather Charcoal Stones from Penitence Route	대성당 참회로에서 질 좋은 숫돌 모아오기
